NO ./textures/42.xpm
SO ./textures/gintama.xpm
WE ./textures/red_brick.xpm
EA ./textures/white_wall.xpm

F 220,100,0
C 225,30,0

11111111111111    1111111111
10000000000001    1000000001
10000111000001    1000000001
10000101000001    1111111111
10000111000001
10000000001001
10001000001001
10010000000001
1000001S000001
10000000010001
10010000001001
10001000000001
10000000011001
10000010000001
10000100000001
11111111111111
